D.W. Griffith : dw-griffith-1
F. W. Murnau : f-w-murnau
Charlie Chaplin : charlie-chaplin
Buster Keaton : buster-keaton
Fritz Lang : fritz-lang-1
Carl Theodor Dreyer : carl-theodor-dreyer-1
Luis Buñuel : luis-bunuel
Dziga Vertov : dziga-vertov
Sergei Eisenstein : sergei-eisenstein-1
Abel Gance : abel-gance
Victor Fleming : victor-fleming
James Whale : james-whale
Frank Capra : frank-capra
Tod Browning : tod-browning
Howard Hawks : howard-hawks
John Ford : john-ford-2
Jean Renoir : jean-renoir
Jean Vigo : jean-vigo
Jean Cocteau : jean-cocteau
Oleksandr Dovzhenko : oleksandr-dovzhenko
Marcel Carné : marcel-carne
Alfred Hitchcock : alfred-hitchcock
Leo McCarey : leo-mccarey
Ernst Lubitsch : ernst-lubitsch
Michael Curtiz : michael-curtiz
Josef von Sternberg : josef-von-sternberg
George Cukor : george-cukor
William A. Wellman : william-a-wellman
Rouben Mamoulian : rouben-mamoulian
William Wyler : william-wyler
Billy Wilder : billy-wilder
Carol Reed : carol-reed
John Huston : john-huston
David Lean : david-lean
Emeric Pressburger : emeric-pressburger
Michael Powell : michael-powell
Maya Deren : maya-deren
Yasujirō Ozu : yasujiro-ozu
Jacques Tourneur : jacques-tourneur
Otto Preminger : otto-preminger
Roberto Rossellini : roberto-rossellini
Vittorio De Sica : vittorio-de-sica-1
Vincente Minnelli : vincente-minnelli
Orson Welles : orson-welles-1
Edgar G. Ulmer : edgar-g-ulmer-1
Raoul Walsh : raoul-walsh
Max Ophüls : max-ophuls
Preston Sturges : preston-sturges
Sidney Lumet : sidney-lumet
Stanley Donen : stanley-donen
Akira Kurosawa : akira-kurosawa
Ingmar Bergman : ingmar-bergman
Stanley Kubrick : stanley-kubrick
François Truffaut : francois-truffaut
Charles Laughton : charles-laughton
Nicholas Ray : nicholas-ray
Joseph L. Makiewicz : joseph-l-mankiewicz
Alan Resnais : alain-resnais
Elia Kazan : elia-kazan
Henri-Georges Clouzot : henri-georges-clouzot
Federico Fellini : federico-fellini
Robert Bresson : robert-bresson
Satyajit Ray : satyajit-ray
Jack Arnold : jack-arnold
Kenji Mizoguchi : kenji-mizoguchi-1
Louis Malle : louis-malle-2
Alexander Mackendrick : alexander-mackendrick
Mikhail Kalatozov : mikhail-kalatozov
Douglas Sirk : douglas-sirk
Sergio Leone : sergio-leone
Roman Polanski : roman-polanski
Robert Wise : robert-wise
Masaki Kobayashi : masaki-kobayashi
George A. Romero : george-a-romero
Jean-Luc Godard : jean-luc-godard-1
Agnès Varda : agnes-varda
Jacques Demy : jacques-demy
John Schlesinger : john-schlesinger
Věra Chytilová : vera-chytilova-3
Jean-Pierre Melville : jean-pierre-melville
Franklin J. Schaffner : franklin-j-schaffner
Arthur Penn : arthur-penn
Michelangelo Antonioni : michelangelo-antonioni
George Roy Hill : george-roy-hill
Chris Marker : chris-marker
Jacques Tati : jacques-tati
Sergei Parajanov : sergei-parajanov
Andrei Tarkovsky : andrei-tarkovsky
Kaneto Shindō : kaneto-shindo-1
Dennis Hopper : dennis-hopper
Toshio Matsumoto : toshio-matsumoto
Robert Aldrich : robert-aldrich
Gillo Pontecorvo : gillo-pontecorvo
Terence Young : terence-young
John Sturges : john-sturges
Mike Nichols : mike-nichols
Hiroshi Teshigahara : hiroshi-teshigahara
Francis Ford Coppola : francis-ford-coppola
Martin Scorsese : martin-scorsese
George Lucas : george-lucas
Ridley Scott : ridley-scott
Steven Spielberg : steven-spielberg
John Carpenter : john-carpenter
Miloš Forman : milos-forman
William Friedkin : william-friedkin
Tobe Hooper : tobe-hooper
Brian De Palma : brian-de-palma
Jim Sharman : jim-sharman
Dario Argento : dario-argento
Mario Bava : mario-bava-1
John G. Avildsen : john-g-avildsen
David Lynch : david-lynch
Terry Gilliam : terry-gilliam
Terry Jones : terry-jones
Nobuhiko Obayashi : nobuhiko-obayashi-2
Woody Allen : woody-allen
Michael Cimino : michael-cimino
George Miller : george-miller
John Cassavetes : john-cassavetes
Pier Paolo Pasolini : pier-paolo-pasolini
Alejandro Jodorowsky : alejandro-jodorowsky
Terrence Malick : terrence-malick
Bob Clark : bob-clark
Chantal Akerman : chantal-akerman
Bob Fosse : bob-fosse
Werner Herzog : werner-herzog
Alan J. Pakula : alan-j-pakula
Mel Brooks : mel-brooks
Sylvester Stallone : sylvester-stallone
Richard Donner : richard-donner
Robert Altman : robert-altman
John Waters : john-waters-2
Hal Ashby : hal-ashby
Philip Kaufman : philip-kaufman
Don Siegel : don-siegel
Peter Weir : peter-weir
Robert Zemeckis : robert-zemeckis
John Hughes : john-hughes
Hayao Miyazaki : hayao-miyazaki
Tim Burton : tim-burton
Rob Reiner : rob-reiner
John McTiernan : john-mctiernan
Isao Takahata : isao-takahata-1
Wim Wenders : wim-wenders
Tony Scott : tony-scott
Katsuhiro Otomo : katsuhiro-otomo-1
James Cameron : james-cameron
Elem Klimov : elem-klimov
Wes Craven : wes-craven
Andrzej Żuławski : andrzej-zuawski
Giuseppe Tornatore : giuseppe-tornatore
Spike Lee : spike-lee
Sam Raimi : sam-raimi
David Cronenberg : david-cronenberg
Joe Dante : joe-dante
Barry Levinson : barry-levinson
Clive Barker : clive-barker
Paul Verhoeven : paul-verhoeven-3
Joel Coen : joel-coen
Ethan Coen : ethan-coen
John Landis : john-landis
David Fincher : david-fincher
Quentin Tarantino : quentin-tarantino
Jonathan Demme : jonathan-demme
Gus Van Sant : gus-van-sant
Lana Wachowski : lana-wachowski
Lilly Wachowski : lilly-wachowski
Frank Darabont : frank-darabont
Chris Columbus : chris-columbus
Richard Linklater : richard-linklater
John Lasseter : john-lasseter-1
Henry Selick : henry-selick
Satoshi Kon : satoshi-kon
Sofia Coppola : sofia-coppola
James Mangold : james-mangold
Danny Boyle : danny-boyle
Luc Besson : luc-besson-1
Sam Mendes : sam-mendes
M. Night Shyamalan : m-night-shyamalan
Mathieu Kassovitz : mathieu-kassovitz
Wong Kar-wai : wong-kar-wai
Michael Mann : michael-mann
Paul Thomas Anderson : paul-thomas-anderson
Roberto Benigni : roberto-benigni
Spike Jonze : spike-jonze
Anthony Minghella : anthony-minghella
Baz Luhrmann : baz-luhrmann
Brad Bird : brad-bird
Wes Anderson : wes-anderson
Hideaki Anno : hideaki-anno
Mamoru Oshii : mamoru-oshii
Vincent Gallo : vincent-gallo
Kiyoshi Kurosawa : kiyoshi-kurosawa
Mel Gibson : mel-gibson
Micahel Haneke : michael-haneke
Curtis Hanson : curtis-hanson
Takashi Miike : takashi-miike
Kathryn Bigelow : kathryn-bigelow
Jan de Bont : jan-de-bont
Roland Emmerich : roland-emmerich
Jane Campion : jane-campion
Oliver Stone : oliver-stone
Krzysztof Kieślowski : krzysztof-kieslowski
Pedro Almodóvar : pedro-almodovar
Clint Eastwood : clint-eastwood
Christopher Nolan : christopher-nolan
Mary Harron : mary-harron
Peter Jackson : peter-jackson
Alfonso Cuarón : alfonso-cuaron
Darren Aronofsky : darren-aronofsky
Park Chan-wook : park-chan-wook
Ang Lee : ang-lee
Jen-Pierre Jeunet : jean-pierre-jeunet
Edgar Wright : edgar-wright
Steven Soderbergh : steven-soderbergh
Bong Joon Ho : bong-joon-ho
Guillermo del Toro : guillermo-del-toro
James Wan : james-wan
Guy Ritchie : guy-ritchie
Martin McDonagh : martin-mcdonagh
Ron Howard : ron-howard
Damien Chazelle : damien-chazelle
Jordan Peele : jordan-peele
Ari Aster : ari-aster
Rian Johnson : rian-johnson
Greta Gerwig : greta-gerwig
Luca Guadagnino : luca-guadagnino
Denis Villeneuve : denis-villeneuve
James Gunn : james-gunn
Taika Waititi : taika-waititi
Ryan Coogler : ryan-coogler
Robert Eggers : robert-eggers
Barry Jenkins : barry-jenkins
Josh Safdie : josh-safdie
Benny Safdie : benny-safdie
Céline Sciamma : celine-sciamma
Chad Stahelski : chad-stahelski
Noah Baumbach : noah-baumbach
Yorgos Lanthimos : yorgos-lanthimos
David Lowery : david-lowery-1
Alex Garland : alex-garland
Sean Baker : sean-baker
Makoto Shinkai : makoto-shinkai
Alejandro Gonzáles Iñárritu : alejandro-gonzalez-inarritu
David O. Russel : david-o-russell
Abel Ferrara : abel-ferrara
Fernando Meirelles : fernando-meirelles
Walter Salles : walter-salles
Kleber Mendonça Filho : kleber-mendonca-filho
Guel Arraes : guel-arraes
Anna Muylaert : anna-muylaert
José Padilha : jose-padilha-1
Héctor Babenco : hector-babenco
Marcos Jorge : marcos-jorge-1
André Klotzel : andre-klotzel
Glauber Rocha : glauber-rocha
Petra Costa : petra-costa
Karim Aïnouz : karim-ainouz-1
Jorge Furtado : jorge-furtado
Gabriel Martins : gabriel-martins
Eduardo Coutinho : eduardo-coutinho
Juliana Rojas : juliana-rojas
Marco Dutra : marco-dutra
Lucrecia Martel : lucrecia-martel-1
Kelly Reichardt : kelly-reichardt
Anselmo Duarte : anselmo-duarte
Suzana Amaral : suzana-amaral
Mário Peixoto : mario-peixoto
José Mojica Marins : jose-mojica-marins
Bruno Barreto : bruno-barreto
Leon Hirszman : leon-hirszman
Nelson Pereira dos Santos : nelson-pereira-dos-santos
Rogério Sganzerla : rogerio-sganzerla
Arnaldo Jabor : arnaldo-jabor
Daniel Rezende : daniel-rezende
Júlio Bressane : julio-bressane-1
Carlos Reichenbach : carlos-reichenbach-1
Luiz Sérgio Person : luiz-sergio-person
Jean Garret : jean-garrett